NO ./textures/north.xpm
SO ./textures/south.xpm
WE ./textures/west.xpm
EA ./textures/east.xpm
F 120,120,120
C 200,200,255

111111111111111111111111111111111111
100000000000000000000000000000000001
101111111111011111111111111111111101
100000000001000000000000000000000001
101111111101011111111111111101111101
100000000001000000000000000001000001
111101111111011111111111111101011111
100001000000000000000000000001000001
101101011111111111111111111101011101
10000100000000000N000000000001000001
111111011111011111111111101111011111
100000010000010000000000100000010001
101111110111111011111101111111110101
100000000100000010000001000000000001
111111111111111111111111111111111111
