NO ./textures/north.xpm
SO ./textures/south.xpm
WE ./textures/west.xpm
EA ./textures/east.xpm

F 220,100,0
C 100,100,255

1111
1A01   # 'A' is invalid ❌
1111
