NO aa.xpm
F 22, 21, 152
EA fshjdfj.xpm



      
WE jshdj.xpm




SO dje.xpm
C 0,2,22

11111111
10000001
10000001
100E0001
11111111