NO aa.xpm
F 22, 21, 152
EA fshjdfj.xpm



      
WE jshdj.xpm




SO dje.xpm
C 0,2,22

11111111     11111111
100000011111110000001
100000010000010000001
1000000111111100E0001
11111111     11111111