NO aa.xpm
F 22, 21, 152
EA fshjdfj.xpm



      
WE jshdj.xpm




SO dje.xpm
C 0,2,22

11111      	101
100N1		101
11111		111