NO p1.png
EA p2.png
WE p3.png
SO p4.png
F 0, 0, 0
C 0    , 2 ,    255

 
 
11111111111111111111111111
10000000000N10000000000001
10000000000010000000000001
10000000000010000000000001
10000000000010000000000001
10000000000000000000000001
11111111111111111111111111